1 2 2975 3646 
1 4 2058 924 3761 1201 
1 5 1201 1748 3749 922 3760 
1 5 3760 3754 1893 2367 2986 
1 6 3760 3766 338 1373 1601 1116 
1 5 2986 1284 3 2076 3646 
1 10 2986 204 2487 338 3772 638 693 3301 1205 445 
1 7 445 1989 1381 1744 485 3656 2975 
1 7 2058 1396 2411 1955 3658 2397 3634 
1 4 3634 3390 1122 3605 
1 3 3605 3597 3585 
1 2 3585 1942 
1 5 3605 1956 3592 1494 3580 
1 4 3580 3125 1643 1557 
1 8 3226 308 2902 1519 288 713 1548 1461 
1 28 1154 3438 1371 3451 275 1794 3492 1863 3500 3362 2207 555 3532 2173 109 2449 3517 966 3520 3524 2345 533 33 3516 3359 457 267 3482 
1 4 3343 773 1546 1794 
1 5 3557 1523 3286 685 33 
1 3 3476 2194 457 
1 4 3044 3442 3458 3476 
1 5 3432 3424 1780 1785 267 
1 2 1780 3442 
1 2 2229 3438 
1 2 3415 2021 
1 4 2022 2434 205 1284 
1 5 2022 1153 2484 2921 3646 
1 7 2022 2824 3175 3363 2 2187 2058 
1 5 247 3785 89 1591 3810 
1 7 3810 1303 3812 1849 792 3110 3086 
1 5 3813 1608 1817 2941 3086 
1 5 3813 2752 2795 166 3838 
1 5 862 1424 2491 544 112 
1 7 112 3135 2935 3340 397 2085 3838 
1 6 3971 430 1010 3946 717 3924 
1 5 265 2068 3925 1752 3924 
1 7 654 2970 1196 1010 3946 717 3924 
1 7 3924 3181 333 497 839 489 112 
1 5 9 3689 1400 3317 1723 
1 7 9 1183 3725 629 3751 803 247 
1 6 9 3699 570 3668 744 3647 
1 7 3647 363 3650 3632 2563 2108 2760 
1 8 247 2278 2623 321 2293 3771 1648 2737 
1 5 247 2278 2623 2932 609 
1 9 247 683 3762 2922 1104 2844 915 3744 2663 
1 3 2359 1241 3810 
1 8 2970 632 4001 1109 3995 3987 1486 3956 
1 5 3956 1486 435 4005 2742 
1 3 2742 4028 1539 
1 4 1539 517 4038 4054 
1 4 1539 1046 3007 1434 
1 5 1434 782 878 536 2416 
1 3 1362 731 517 
1 4 4038 1633 3328 1113 
1 3 1113 3976 279 
1 2 279 878 
1 2 1825 1335 
1 4 1825 1632 281 4134 
1 3 4134 1344 1308 
1 4 1335 587 2302 1846 
1 3 1825 4172 4164 
1 2 1308 2880 
1 3 706 1907 587 
1 5 706 228 1762 2930 1186 
1 7 2495 1047 4229 4222 4213 703 1762 
1 7 4277 4263 2680 900 2003 4243 4229 
1 2 4272 1773 
1 5 1773 2324 1979 739 4277 
1 5 93 980 3292 580 1186 
1 9 4217 1853 4197 114 2654 4178 1960 4168 93 
1 11 4108 2446 2868 1218 4136 4127 260 4153 502 148 518 
1 2 518 114 
1 4 2156 3998 2565 4024 
1 4 2565 369 4056 4067 
1 2 4067 4093 
1 7 4067 2945 530 771 25 3272 61 
1 4 61 4116 193 2691 
1 3 691 1002 3272 
1 2 2691 1962 
1 4 4108 1426 4087 4093 
1 4 654 3202 36 4024 
1 4 1437 4031 2541 2742 
1 4 1437 4034 97 4001 
1 5 1437 526 2979 32 1362 
1 7 1437 2031 2855 2524 411 2796 93 
1 3 2359 2185 1545 
1 5 1627 712 410 3800 862 
1 5 1627 2153 3782 1428 330 
1 4 330 3804 405 3813 
1 7 1627 951 1909 3757 3753 3247 311 
1 5 311 2827 3715 3102 3723 
1 3 1428 1449 828 
1 4 828 2835 2420 3690 
1 6 3690 1150 2727 3655 2611 3629 
1 8 3629 1651 3673 3024 3700 813 2492 1723 
1 2 3685 3317 
1 4 3685 876 1041 813 
1 9 3723 3710 2070 3692 179 3659 1669 3040 884 
1 7 884 1136 1260 1039 1570 1322 894 
1 3 894 2241 456 
1 4 2151 2086 2895 894 
1 3 3217 2808 2151 
1 4 3217 3391 1202 2611 
1 5 2151 3568 2271 417 933 
1 4 933 3540 2259 277 
1 7 277 3567 2829 2907 3614 2315 1651 
1 5 2957 2839 3546 2616 3527 
1 9 3527 2956 684 3494 1878 959 3469 3454 1479 
1 7 1479 2519 1737 1746 3467 2298 3445 
1 3 3445 898 3434 
1 8 1564 1263 1101 169 1742 3474 3461 3227 
1 2 1878 1742 
1 8 997 1254 3584 2303 872 895 3590 2264 
1 3 1290 3341 997 
1 3 1290 1720 604 
1 3 2264 881 2957 
1 9 1263 1765 3531 3537 864 1912 3559 639 3584 
1 5 553 1107 618 2427 664 
1 4 664 4359 781 2030 
1 3 1107 618 2929 
1 3 2929 4317 1929 
1 3 1929 4291 2038 
1 4 2038 3013 4304 553 
1 4 553 39 3249 2495 
1 5 2038 819 492 4249 3249 
1 6 2030 2779 4385 1354 219 1763 
1 7 3259 176 2704 547 4382 1411 664 
1 4 1411 4378 2169 1354 
1 8 4496 631 2571 4540 749 2878 4587 2239 
1 6 2239 4587 1450 870 708 3143 
1 5 3143 4517 2291 4494 382 
1 4 4487 1769 761 382 
1 8 4487 2412 4472 816 4447 348 2337 1440 
1 2 1440 4406 
1 9 4406 1152 4400 1713 4366 3000 880 4398 2649 
1 5 259 53 413 4610 2239 
1 6 1555 1914 449 42 4600 2239 
1 2 1555 224 
1 7 224 1007 2032 1465 4655 1899 420 
1 4 4583 3365 2247 224 
1 3 4583 760 1408 
1 8 1408 3108 2688 1538 1913 4499 4508 4496 
1 6 382 4480 4468 797 4467 832 
1 6 796 2104 4522 149 626 2543 
1 4 2543 4523 4546 4561 
1 7 1167 4528 1059 2450 1504 178 2013 
1 6 4561 4560 4580 2454 947 2013 
1 7 4663 353 4678 4673 2338 2057 46 
1 5 4663 4660 4642 2475 2013 
1 3 46 1708 4645 
1 5 4490 1043 2881 733 2438 
1 6 2438 4542 460 4534 2430 1167 
1 7 2438 2759 4590 1657 3032 49 2338 
1 6 4490 2001 2798 471 4477 820 
1 4 796 746 1787 867 
1 4 867 2112 4510 854 
1 6 1356 1660 704 1475 1054 867 
1 7 4680 2374 2470 1709 1124 1298 1602 
1 3 1602 2212 1359 
1 5 1602 4569 610 226 1356 
1 5 1359 2999 1835 2042 1356 
1 3 1385 1844 355 
1 4 355 2719 1219 1291 
1 4 1385 1644 4360 662 
1 3 662 1824 3094 
1 5 662 2270 4327 545 4303 
1 6 3094 123 3336 1925 4306 1842 
1 3 1842 594 556 
1 8 2790 2811 132 4334 2168 1320 2282 1842 
1 3 3224 185 4275 
1 8 4244 3389 1060 1025 4225 1939 623 4257 
1 2 4257 4261 
1 2 392 4247 
1 2 392 4248 
1 2 4248 4247 
1 2 4248 4261 
1 9 4247 1220 4205 1360 4191 282 3207 4152 4139 
1 2 1220 4218 
1 8 4139 1456 3294 1328 4129 212 2405 3004 
1 2 3004 916 
1 8 4166 1334 398 4122 3244 2937 2978 3004 
1 4 2035 313 4300 4270 
1 4 2035 1376 24 1291 
1 5 1291 866 1089 1165 4327 
1 6 545 2036 1495 4286 737 4270 
1 5 4260 170 1103 1681 4227 
1 3 4227 23 4251 
1 6 4260 170 2265 4274 1607 4300 
1 6 3310 1420 2756 3186 2099 4260 
1 5 4260 4250 1313 4223 1890 
1 6 4260 1227 753 1526 4221 1443 
1 4 1443 4195 354 518 
1 4 1890 4216 3271 1443 
1 3 142 3422 1731 
1 3 504 1625 3456 
1 9 3456 3452 1121 541 2232 1042 3307 721 142 
1 5 4256 3223 2138 1229 4329 
1 6 2760 557 3073 1732 1137 3619 
1 6 1137 1316 2237 2284 3684 2411 
1 4 1316 3327 261 1494 
1 3 1545 3852 319 
1 3 319 804 3836 
1 4 3836 2901 106 3086 
1 4 2653 2927 874 166 
1 4 4256 1798 637 1675 
1 4 2261 4204 4211 1675 
1 4 2261 2918 447 3079 
1 4 447 4159 3236 4144 
1 6 4144 3236 2622 1057 901 1330 
1 6 3807 3274 2814 478 1921 3832 
1 8 2814 1831 2738 1005 616 3282 337 925 
1 4 478 2919 3139 2144 
1 4 2144 1795 1771 681 
1 5 681 43 1011 68 2083 
1 2 3282 2128 
1 6 2128 80 1571 3324 3705 2083 
1 4 2083 2673 1318 3712 
1 6 1318 682 1482 3615 1527 2309 
1 9 1664 2253 3116 2578 295 943 37 2325 2723 
1 3 2125 214 37 
1 7 2723 1855 240 320 1593 678 2144 
1 6 609 3815 2972 1454 2800 1964 
1 6 3956 1253 690 2859 3942 2416 
1 3 4054 842 1362 
1 7 4054 4050 4068 2499 1281 2672 1344 
1 4 4134 4151 1982 4164 
1 6 4164 1321 1467 235 4167 1186 
1 8 3557 1523 1179 79 2279 3495 3484 3476 
1 4 2975 1757 1996 496 
1 5 3657 2593 1634 3702 1381 
1 10 2058 1230 1521 3728 55 3695 1908 1605 2202 2663 
1 4 3695 269 1342 3073 
1 4 3749 877 2093 3363 
1 6 1388 962 944 181 2852 1022 
1 3 962 3916 56 
1 4 1388 3129 3967 1998 
1 5 1388 2336 1037 2039 3970 
1 5 61 4086 1234 1485 220 
1 4 2067 4019 1566 691 
1 9 2526 2961 21 2848 245 1211 807 2511 916 
1 2 149 4491 
1 4 4491 1399 3142 994 
1 4 994 2423 4506 854 
1 3 4261 2113 2553 
1 5 4275 4283 676 1867 2553 
1 4 496 2352 640 1286 
1 2 496 3353 
1 3 1286 1000 3599 
1 4 3566 1366 3593 1286 
1 3 2974 350 3566 
1 3 2974 2706 709 
1 4 709 3525 1695 2751 
1 4 3657 3628 1115 1286 
1 4 3599 1967 1796 519 
1 3 1700 173 519 
1 4 3599 2097 2458 1700 
1 4 1700 2569 1405 2506 
1 6 1980 2912 2778 1900 1405 2506 
1 4 2506 1733 2731 925 
1 3 519 3606 1351 
1 2 1351 1969 
1 2 1969 4702 
1 5 1351 3602 1749 3100 286 
1 17 1351 794 2314 2627 2394 229 3337 255 1547 3472 3457 2496 3441 2650 3428 841 3420 
1 2 784 3646 
1 2 1201 1061 
1 2 1116 3817 
1 8 1900 3698 3675 560 3649 211 2184 3657 
1 6 3544 1838 2642 3571 387 794 
1 5 3544 442 3547 1580 1394 
1 13 1100 2223 2661 135 434 1051 3042 2398 3091 2100 671 2258 3457 
1 3 286 3617 3637 
1 5 3637 1155 1600 3693 80 
1 9 2751 1618 399 1997 1134 1906 174 3529 2205 
1 3 399 498 2997 
1 4 2997 686 2801 1001 
1 2 1001 3441 
1 3 76 585 1177 
1 4 3485 1382 1169 1177 
1 5 3485 3489 3193 2602 2214 
1 4 3226 1203 822 3029 
1 2 3029 3041 
1 4 3041 1626 3475 3485 
1 2 822 1626 
1 3 3061 421 2602 
1 4 3061 1869 12 1177 
1 5 1177 3453 3447 422 1461 
1 3 3485 1637 3447 
1 2 1019 3973 
1 3 118 1275 3973 
1 2 1019 2037 
1 2 1698 1678 
1 4 1678 2389 2327 220 
1 5 2526 4013 218 4009 2459 
1 5 2961 1106 2670 1024 2037 
1 7 3917 740 2764 17 511 538 2670 
1 3 3917 1077 3928 
1 5 3928 184 1950 552 1256 
1 6 56 2766 1133 2243 3911 1256 
1 5 1256 1948 3939 1667 2852 
1 3 1022 551 67 
1 4 67 1361 3385 1998 
1 5 2388 1476 4016 217 1998 
1 4 2388 1957 1171 3970 
1 5 1857 1926 1365 4002 67 
1 6 4016 855 1187 2328 3266 1857 
1 3 2010 4154 2809 
1 3 763 458 2261 
1 10 763 58 3105 299 2174 134 2159 4147 4137 2809 
1 4 4154 679 1112 2159 
1 3 2010 2481 1329 
1 5 4226 1337 4207 829 3105 
1 3 3254 168 957 
1 5 957 843 433 1065 1057 
1 9 4226 4233 4253 4262 2409 921 349 1257 2277 
1 5 2277 2198 4316 38 4312 
1 4 4312 1307 385 3374 
1 6 3374 559 429 3038 1231 1086 
1 6 3374 2372 543 4387 1756 4394 
1 3 4394 4399 126 
1 2 126 1898 
1 5 1898 2696 4402 48 1864 
1 4 1864 2355 225 4455 
1 2 4455 2176 
1 7 2176 4457 441 1224 1927 151 1144 
1 4 4394 4408 4416 151 
1 5 2928 2679 2804 2149 1144 
1 5 1936 4377 2913 4390 48 
1 4 1936 1398 4340 4329 
1 5 4329 4340 1774 2444 4335 
1 3 4335 1370 928 
1 3 1397 296 263 
1 3 263 3154 4349 
1 6 4349 720 1806 78 812 127 
1 6 4409 3140 825 4364 115 2444 
1 6 4409 493 2815 4418 3296 1759 
1 3 1759 2406 1194 
1 12 1194 3171 641 1295 1247 4471 4466 309 4444 253 104 2355 
1 3 3237 675 4455 
1 10 3237 675 583 4478 1561 4498 2877 549 102 2396 
1 10 2396 2850 4541 1199 28 595 2230 2000 602 2928 
1 7 2396 4559 1829 3106 3166 4581 4568 
1 2 1082 4581 
1 4 1082 596 4627 586 
1 4 586 2886 1390 1189 
1 4 596 4611 4598 1245 
1 5 1829 2111 2081 1158 2161 
1 3 2161 2418 4632 
1 7 586 1943 1031 1788 199 4677 1616 
1 6 1616 3267 2942 1722 304 3257 
1 2 3257 1310 
1 7 1488 1340 1949 2300 4584 3240 1310 
1 8 820 4485 1647 2614 1865 1588 3382 1488 
1 3 394 2033 821 
1 3 529 2143 821 
1 4 821 1845 2195 820 
1 5 820 1496 1947 1595 4463 
1 4 4463 1582 1705 3206 
1 3 3206 1469 2391 
1 5 2391 4383 558 298 127 
1 6 658 2584 1935 1754 2967 4463 
1 3 658 1881 4493 
1 4 4493 409 2294 641 
1 5 658 1228 3078 4429 1759 
1 8 658 2311 4502 990 486 4555 2858 1310 
1 7 3382 831 2246 1489 1985 1636 1754 
1 3 118 1080 1698 
1 7 1698 2473 1464 766 1497 3914 929 
1 8 929 3891 1978 3880 911 3368 2225 319 
1 8 1964 1779 2422 3890 1239 1740 935 3891 
1 7 1964 779 1687 29 3905 1809 3917 
1 6 3615 2120 1682 2129 2401 1394 
1 4 3791 1438 2941 3086 
1 7 1334 524 718 953 2660 45 4218 
1 4 1330 356 2451 3235 
1 2 3037 2451 
1 3 3037 3993 2715 
1 10 3037 2601 1738 1074 3026 2435 41 3022 3887 1833 
1 5 41 1966 2122 86 2521 
1 9 2521 3945 1679 18 3972 2233 2988 4006 1481 
1 6 957 1067 2088 91 2252 1481 
1 5 2715 3303 2006 4062 901 
1 6 2362 3867 1172 2351 336 3837 
1 5 2362 514 1559 3856 3841 
1 3 3837 2393 3856 
